Personagens Principais:
- Sakura Tanaka (田中 さくら)
- Tatsuya Sato (佐藤 たつや)

Pais de Sakura:
- Mãe: Kaori Tanaka (田中 かおり)
- Pai: Takashi Tanaka (田中 たかし)

Pais de Tatsuya:
- Mãe: Aki Sato (佐藤 あき)
- Pai: Hiroshi Sato (佐藤 ひろし)

Amigos de Sakura:
- Yuki Yamamoto (山本 ゆき)
- Satoshi Nakamura (中村 さとし)
- Haruka Suzuki (鈴木 はるか)
- Ryota Ito (伊藤 りょうた)

Amigos de Tatsuya:
- Ren Kobayashi (小林 れん)
- Ayumi Tanaka (田中 あゆみ)
- Yuji Kimura (木村 ゆうじ)
- Eri Nakajima (中島 えり)

Amigos em Comum:
- Kazuki Watanabe (渡辺 かずき)
- Mai Ishikawa (石川 まい)y
- Tadara Fujita (藤田 ただら)
- Natsumi Yamada (山田 なつみ)

















Personagens Principais:
- Isabella: Hana (ハナ)
- Rafael: Tatsuya (タツヤ)

Pais de Isabella:
- Mãe Ana: Kaori (カオリ)
- Pai Eduardo: Takashi (タカシ)

Pais de Rafael:
- Mãe Mariana: Aki (アキ)
- Pai Carlos: Hiroshi (ヒロシ)

Amigos de Isabella:
- Camila: Yuki (ユキ)
- Thiago: Satoshi (サトシ)
- Larissa: Haruka (ハルカ)
- Felipe: Ryota (リョウタ)

Amigos de Rafael:
- Lucas: Ren (レン)
- Vanessa: Ayumi (アユミ)
- Matheus: Yuji (ユウジ)
- Carolina: Eri (エリ)

Amigos em Comum:
- André: Kazuki (カズキ)
- Luana: Mai (マイ)
- Daniel: Tadara (ショウタ)
- Mariana: Natsumi (ナツミ)




















- Sakura (サクラ): "Cerejeira" em japonês.
- Tatsuya (タツヤ): "Dragão generoso" em japonês.
- Kaori (カオリ): "Perfume" ou "Fragrância" em japonês.
- Takashi (タカシ): "Nobre" ou "Respeitoso" em japonês.
- Aki (アキ): "Outono" em japonês.
- Hiroshi (ヒロシ): "Generoso" ou "Generosidade" em japonês.
- Yuki (ユキ): "Neve" em japonês.
- Satoshi (サトシ): "Rapidamente alcançado" em japonês.
- Haruka (ハルカ): "Distante" ou "Longe" em japonês.
- Ryota (リョウタ): "Refrescante" ou "Grande frescor" em japonês.
- Ren (レン): "Lótus" em japonês.
- Ayumi (アユミ): "Andar" ou "Caminho" em japonês.
- Yuji (ユウジ): "Segundo filho" em japonês.
- Eri (エリ): Pode ter vários significados, incluindo "Lindo" e "Luz" em japonês.
- Kazuki (カズキ): "Harmonia" ou "Árvore" em japonês.
- Mai (マイ): "Dança" ou "Belas flores" em japonês.
- Tadara (タダラ): Não tem um significado específico, pois é um nome fictício.
- Natsumi (ナツミ): "Beleza do verão" em japonês.





















Pais dos Amigos de Sakura:
- Mãe de Yuki: Akiko Yamamoto (山本 明子)
- Pai de Yuki: Hiroshi Yamamoto (山本 博士)

- Mãe de Satoshi: Miko Nakamura (中村 美子)
- Pai de Satoshi: Kenji Nakamura (中村 健二)

- Mãe de Haruka: Yoko Suzuki (鈴木 陽子)
- Pai de Haruka: Tetsuya Suzuki (鈴木 哲也)

- Mãe de Ryota: Emi Ito (伊藤 絵美)
- Pai de Ryota: Masaru Ito (伊藤 勝)





Pais dos Amigos de Tatsuya:
- Mãe de Ren: Yuki Kobayashi (小林 由紀)
- Pai de Ren: Kazuki Kobayashi (小林 和樹)

- Mãe de Ayumi: Tomoko Tanaka (田中 ともこ)
- Pai de Ayumi: Tetsuya Tanaka (田中 哲也)

- Mãe de Yuji: Rika Kimura (木村 里佳)
- Pai de Yuji: Takashi Kimura (木村 隆)

- Mãe de Eri: Kiyomi Nakajima (中島 清美)
- Pai de Eri: Daisuke Nakajima (中島 大輔)